map_cols=24
map_rows=20
tile_width=64
tile_height=64
tile_path=res\map.png
tile_grid_id=1
back_layer_name=back
barrier_layer_name=barrier
<layer name=back>
1,1,1,1,1,1,1,1,1,1,1,1,1,1,1,1,1,1,1,1,1,1,1,1,
1,1,1,1,1,1,1,1,1,1,1,1,1,1,1,1,1,1,1,1,1,1,1,1,
1,1,1,1,1,1,1,1,1,1,1,1,1,1,1,1,1,1,1,1,1,1,1,1,
1,1,1,1,1,1,1,1,1,1,1,1,1,1,1,1,1,1,1,1,1,1,1,1,
1,1,1,1,1,1,1,1,1,1,1,1,1,1,1,1,1,1,1,1,1,1,1,1,
1,1,1,1,1,1,1,1,1,1,1,1,1,1,1,1,1,1,1,1,1,1,1,1,
1,1,1,1,1,1,1,1,1,1,1,1,1,1,1,1,1,1,1,1,1,1,1,1,
1,1,1,1,1,1,1,1,1,1,1,1,1,1,1,1,1,1,1,1,1,1,1,1,
1,1,1,1,1,1,1,1,1,1,1,1,1,1,1,1,1,1,1,1,1,1,1,1,
1,1,1,1,1,1,1,1,1,1,1,1,1,1,1,1,1,1,1,1,1,1,1,1,
1,1,1,1,1,1,1,1,1,1,1,1,1,1,1,1,1,1,1,1,1,1,1,1,
1,1,1,1,1,1,1,1,1,1,1,1,1,1,1,1,1,1,1,1,1,1,1,1,
1,1,1,1,1,1,1,1,1,1,1,1,1,1,1,1,1,1,1,1,1,1,1,1,
1,1,1,1,1,1,1,1,1,1,1,1,1,1,1,1,1,1,1,1,1,1,1,1,
1,1,1,1,1,1,1,1,1,1,1,1,1,1,1,1,1,1,1,1,1,1,1,1,
1,1,1,1,1,1,1,1,1,1,1,1,1,1,1,1,1,1,1,1,1,1,1,1,
1,1,1,1,1,1,1,1,1,1,1,1,1,1,1,1,1,1,1,1,1,1,1,1,
1,1,1,1,1,1,1,1,1,1,1,1,1,1,1,1,1,1,1,1,1,1,1,1,
1,1,1,1,1,1,1,1,1,1,1,1,1,1,1,1,1,1,1,1,1,1,1,1,
1,1,1,1,1,1,1,1,1,1,1,1,1,1,1,1,1,1,1,1,1,1,1,1
</layer>
<layer name=barrier>
2,14,14,14,14,14,14,14,14,14,14,14,14,14,14,14,14,14,14,14,14,14,14,5,
7,0,0,0,0,0,0,0,4,0,0,0,0,0,0,4,0,0,0,0,0,0,0,10,
7,4,14,14,14,14,14,14,4,0,0,0,0,0,0,4,4,14,14,14,14,14,14,10,
7,0,0,0,0,0,0,0,4,0,14,14,14,14,0,4,0,0,0,0,0,0,0,10,
7,14,14,14,14,14,14,3,4,0,0,0,0,0,0,4,14,14,14,14,14,14,3,10,
7,0,0,0,0,0,0,0,4,0,4,0,0,4,0,4,0,0,0,0,0,0,0,10,
7,3,14,14,14,14,14,14,4,0,0,0,0,0,0,4,3,14,14,14,14,14,14,10,
7,0,0,0,0,0,0,0,4,0,0,0,0,0,0,4,0,0,0,0,0,0,0,10,
7,14,14,14,8,14,14,4,4,0,0,3,3,0,0,4,14,14,14,8,14,14,4,10,
7,0,0,0,0,0,0,0,4,0,0,3,3,0,0,4,0,0,0,0,0,0,0,10,
7,4,14,14,14,9,14,14,4,0,0,0,0,0,0,4,4,14,14,14,9,14,14,10,
7,0,0,0,0,0,0,0,4,0,0,0,0,0,0,4,0,0,0,0,0,0,0,10,
7,14,14,14,14,14,14,3,4,0,4,0,0,4,0,4,14,14,14,14,14,14,3,10,
7,0,0,0,0,0,0,0,4,0,14,0,0,14,0,4,0,0,0,0,0,0,0,10,
7,4,14,14,14,14,14,14,4,0,14,14,14,14,0,4,4,14,14,14,14,14,14,10,
7,0,0,0,0,0,0,0,4,0,0,0,0,0,0,4,0,0,0,0,0,0,0,10,
7,0,0,9,8,4,0,0,4,0,0,0,0,0,0,4,0,0,9,8,4,0,0,10,
7,0,0,8,9,4,0,0,4,0,0,0,0,0,0,4,0,0,8,9,4,0,0,10,
7,0,0,0,0,0,0,0,4,0,0,0,0,0,0,4,0,0,0,0,0,0,0,10,
12,14,14,14,14,14,14,14,14,14,14,14,14,14,14,14,14,14,14,14,14,14,14,15
</layer>