map_cols=24
map_rows=20
tile_width=64
tile_height=64
tile_path=res\map.png
tile_grid_id=1
back_layer_name=back
barrier_layer_name=barrier
<layer name=back>
1,1,1,1,1,1,1,1,1,1,1,1,1,1,1,1,1,1,1,1,1,1,1,1,
1,1,1,1,1,1,1,1,1,1,1,1,1,1,1,1,1,1,1,1,1,1,1,1,
1,1,1,1,1,1,1,1,1,1,1,1,1,1,1,1,1,1,1,1,1,1,1,1,
1,1,1,1,1,1,1,1,1,1,1,1,1,1,1,1,1,1,1,1,1,1,1,1,
1,1,1,1,1,1,1,1,1,1,1,1,1,1,1,1,1,1,1,1,1,1,1,1,
1,1,1,1,1,1,1,1,1,1,1,1,1,1,1,1,1,1,1,1,1,1,1,1,
1,1,1,1,1,1,1,1,1,1,1,1,1,1,1,1,1,1,1,1,1,1,1,1,
1,1,1,1,1,1,1,1,1,1,1,1,1,1,1,1,1,1,1,1,1,1,1,1,
1,1,1,1,1,1,1,1,1,1,1,1,1,1,1,1,1,1,1,1,1,1,1,1,
1,1,1,1,1,1,1,1,1,1,1,1,1,1,1,1,1,1,1,1,1,1,1,1,
1,1,1,1,1,1,1,1,1,1,1,1,1,1,1,1,1,1,1,1,1,1,1,1,
1,1,1,1,1,1,1,1,1,1,1,1,1,1,1,1,1,1,1,1,1,1,1,1,
1,1,1,1,1,1,1,1,1,1,1,1,1,1,1,1,1,1,1,1,1,1,1,1,
1,1,1,1,1,1,1,1,1,1,1,1,1,1,1,1,1,1,1,1,1,1,1,1,
1,1,1,1,1,1,1,1,1,1,1,1,1,1,1,1,1,1,1,1,1,1,1,1,
1,1,1,1,1,1,1,1,1,1,1,1,1,1,1,1,1,1,1,1,1,1,1,1,
1,1,1,1,1,1,1,1,1,1,1,1,1,1,1,1,1,1,1,1,1,1,1,1,
1,1,1,1,1,1,1,1,1,1,1,1,1,1,1,1,1,1,1,1,1,1,1,1,
1,1,1,1,1,1,1,1,1,1,1,1,1,1,1,1,1,1,1,1,1,1,1,1,
1,1,1,1,1,1,1,1,1,1,1,1,1,1,1,1,1,1,1,1,1,1,1,1
</layer>
<layer name=barrier>
2,14,14,14,14,14,14,14,14,14,14,14,14,14,14,14,14,14,14,14,14,14,14,5,
7,0,0,0,0,0,0,0,0,0,0,0,0,0,0,0,0,0,0,0,0,0,0,10,
7,0,0,0,0,0,0,0,0,0,0,0,0,0,0,0,0,0,0,0,0,0,0,10,
7,0,0,2,3,5,14,14,5,0,0,0,0,0,0,2,14,14,2,3,5,0,0,10,
7,0,0,7,0,10,0,0,10,0,0,0,0,0,0,7,0,0,7,0,10,0,0,10,
7,0,0,7,0,10,0,0,10,0,0,0,0,0,0,7,0,0,7,0,10,0,0,10,
7,0,0,7,0,10,0,0,12,3,14,14,14,14,3,15,0,0,7,0,10,0,0,10,
7,0,0,7,0,10,0,0,0,0,0,0,0,0,0,0,0,0,7,0,10,0,0,10,
7,0,0,7,0,10,0,0,0,0,0,3,3,0,0,0,0,0,7,0,10,0,0,10,
7,0,0,7,14,10,0,0,0,0,2,0,0,5,0,0,0,0,7,14,10,0,0,10,
7,0,0,7,0,10,0,0,0,0,9,0,0,9,0,0,0,0,7,0,10,0,0,10,
7,0,0,7,0,10,0,0,0,0,0,3,3,0,0,0,0,0,7,0,10,0,0,10,
7,0,0,7,0,10,0,0,0,0,0,0,0,0,0,0,0,0,7,0,10,0,0,10,
7,0,0,7,0,10,0,0,2,3,14,14,14,14,3,5,0,0,7,0,10,0,0,10,
7,0,0,7,0,10,0,0,7,0,0,0,0,0,0,10,0,0,7,0,10,0,0,10,
7,0,0,7,0,10,0,0,7,0,0,0,0,0,0,10,0,0,7,0,10,0,0,10,
7,0,0,12,3,8,14,14,14,0,0,0,0,0,0,14,14,14,8,3,15,0,0,10,
7,0,0,0,0,0,0,0,0,0,0,0,0,0,0,0,0,0,0,0,0,0,0,10,
7,0,0,0,0,0,0,0,0,0,0,0,0,0,0,0,0,0,0,0,0,0,0,10,
12,14,14,14,14,14,14,14,14,14,14,14,14,14,14,14,14,14,14,14,14,14,14,15
</layer>